PanchayatId,AssemblyId,BlockId,Name,Population,Male,Female,SC,Scmale,ScFemale,ST,Stmale,StFemale
1,210,1,Alagankulam,8009,3936,4073,205,94,111,0,0,0
2,211,1,Attangarai,2549,1289,1260,54,28,26,0,0,0
3,211,1,Enmanamkondan,7184,3625,3559,348,178,170,1,0,1
4,211,1,Irumeni,2568,1336,1232,32,21,11,0,0,0
5,210,1,Karan,2320,1173,1147,0,0,0,2,1,1
6,211,1,Keelanagachi,3678,1853,1825,26,13,13,0,0,0
7,211,1,Koravalli,829,359,470,0,0,0,0,0,0
8,211,1,Kumbaram,2114,1082,1032,0,0,0,0,0,0
9,211,1,Kusavankudi,1762,871,891,758,365,393,0,0,0
10,211,1,Manankudi,1512,752,760,58,28,30,0,0,0
11,211,1,Marakayarpattinam,1180,605,575,73,38,35,6,3,3
12,211,1,Nochiyurani,931,471,460,0,0,0,0,0,0
13,211,1,Pamban,17712,9012,8700,118,63,55,0,0,0
14,210,1,Panaikulam,7464,3549,3915,303,143,160,3,1,2
15,210,1,Pattinam Kattan,17601,8984,8617,1395,723,672,4,2,2
16,211,1,Perungulam,2957,1402,1555,25,11,14,0,0,0
17,211,1,Pirappanvalasai,1838,912,926,0,0,0,0,0,0
18,211,1,Pudumadam,8760,4454,4306,85,47,38,0,0,0
19,210,1,Puduvalasai,3491,1805,1686,4,2,2,0,0,0
20,211,1,Rettaiyurani,3399,1777,1622,7,4,3,0,0,0
21,211,1,Sambadaiyarkulam,1449,730,719,1,1,0,0,0,0
22,211,1,Sattakkonvalasai,2623,1295,1328,51,26,25,0,0,0
23,211,1,Tamaraikulam,1681,830,851,192,96,96,0,0,0
24,210,1,Terbhogi,2718,1339,1379,141,62,79,0,0,0
25,211,1,Thangachimadam,20107,10151,9956,385,160,225,3,1,2
26,211,1,Valantaravai,8445,4230,4215,1363,676,687,0,0,0
27,211,1,Vallarioodai,1100,558,542,16,8,8,0,0,0
28,211,1,Vedalai,6371,3270,3101,10,6,4,15,4,11
1,210,2,Achchundanvayal,2945,1476,1469,1301,633,668,0,0,0
2,210,2,Athyuthu,2717,1390,1327,219,110,109,0,0,0
3,210,2,Chitoor,1660,871,789,1202,630,572,0,0,0
4,210,2,Chittrakkottai,8574,4100,4474,900,444,456,0,0,0
5,210,2,Devipattinam,11599,5897,5702,1506,773,733,9,4,5
6,210,2,Ilamanoor,1196,611,585,450,235,215,0,0,0
7,210,2,Kalanikudi,1091,518,573,441,207,234,0,0,0
8,210,2,Karendal,1313,675,638,438,220,218,0,0,0
9,210,2,Karukudi,843,438,405,141,73,68,0,0,0
10,210,2,Kavanur,2064,1019,1045,741,369,372,0,0,0
11,210,2,Madavanur,1695,872,823,553,285,268,0,0,0
12,210,2,Medakottan,2323,1184,1139,2,2,0,0,0,0
13,210,2,Naranamangalam,1764,895,869,505,249,256,0,0,0
14,210,2,Pandamangalam,918,466,452,229,113,116,0,0,0
15,210,2,Paravoor,4699,2384,2315,1917,978,939,33,15,18
16,210,2,Peruvayal,1410,699,711,1155,564,591,0,0,0
17,210,2,Pullangudi,1519,792,727,706,378,328,0,0,0
18,210,2,Puthendal,2199,1094,1105,835,427,408,0,0,0
19,210,2,Rajasuriamadai,5200,2682,2518,985,511,474,0,0,0
20,210,2,Sakkarakottai,15355,7632,7723,2859,1321,1538,12,5,7
21,210,2,Surankottai,5873,3003,2870,2633,1330,1303,133,68,65
22,210,2,Therkuthalavai,4698,2407,2291,971,485,486,0,0,0
23,210,2,Thiruvolhiyakalugoorani,1614,811,803,271,136,135,0,0,0
24,210,2,Toruvalur,2616,1304,1312,1616,795,821,0,0,0
25,210,2,Vennathur,2826,1435,1391,469,229,240,0,0,0
1,210,3,A.Manakudi,1604,762,842,328,163,165,0,0,0
2,210,3,Alagarthevankottai,1854,921,933,484,233,251,0,0,0
3,210,3,Anandur,2773,1375,1398,429,215,214,20,7,13
4,210,3,Arunuthimangalam,2265,1163,1102,438,229,209,0,0,0
5,210,3,Ayangudi,2277,1146,1131,423,208,215,0,0,0
6,210,3,Chitturuvadi,1952,973,979,433,213,220,0,0,0
7,210,3,Govindamangalam,1367,685,682,353,180,173,0,0,0
8,210,3,Gudalur,1407,752,655,166,94,72,0,0,0
9,210,3,Janaveli,2485,1228,1257,431,206,225,0,0,0
10,210,3,Kadalur,3911,1838,2073,2443,1140,1303,0,0,0
11,210,3,Kallikudi,1261,611,650,302,150,152,0,0,0
12,210,3,Karkathakudi,2249,1113,1136,294,148,146,0,0,0
13,210,3,Karungudi,2446,1200,1246,553,269,284,0,0,0
14,210,3,Kavanakottai,1397,693,704,118,59,59,0,0,0
15,210,3,Kavanoor,2185,1078,1107,301,158,143,0,0,0
16,210,3,Kothidal Kalakudi,714,354,360,285,136,149,0,0,0
17,210,3,Kottagudi,1673,826,847,425,211,214,0,0,0
18,210,3,Melapanaiyur,975,490,485,369,181,188,0,0,0
19,210,3,Odaikkal,911,461,450,162,85,77,0,0,0
20,210,3,Paranur,2878,1405,1473,858,429,429,5,2,3
21,210,3,Pitchanakurichi,1080,526,554,520,255,265,0,0,0
22,210,3,Pullamadai,3634,1820,1814,263,126,137,2,1,1
23,210,3,Radhanur,2402,1247,1155,334,165,169,0,0,0
24,210,3,Sattanur,1612,796,816,125,57,68,0,0,0
25,210,3,Sengudi,735,377,358,47,19,28,0,0,0
26,210,3,Sethidal,1799,919,880,162,90,72,0,0,0
27,210,3,Sevaipattai,1450,742,708,312,148,164,0,0,0
28,210,3,Sholandur,1730,864,866,907,462,445,0,0,0
29,210,3,Sirunagudi,832,420,412,111,55,56,0,0,0
30,210,3,Thirutheravalai,1412,684,728,345,178,167,0,0,0
31,210,3,Thumbadakkakottai,2601,1300,1301,645,316,329,0,0,0
32,210,3,Tiruppalaikkudi,8824,4142,4682,3647,1776,1871,1,0,1
33,210,3,Uranagudi,1078,528,550,425,215,210,0,0,0
34,210,3,Vadakalur,1037,528,509,120,57,63,0,0,0
35,210,3,Varavani,1970,1012,958,541,276,265,0,0,0
1,211,4,Alangulam,1395,705,690,867,435,432,0,0,0
2,211,4,Chinnandivalasai,1798,897,901,0,0,0,0,0,0
3,211,4,Ekkakudi,2629,1360,1269,610,302,308,0,0,0
4,211,4,Kalari,1443,720,723,1227,610,617,0,0,0
5,211,4,Kalimankundu,2502,1256,1246,16,6,10,0,0,0
6,211,4,Kanjirangudi,7465,3791,3674,1071,539,532,1,1,0
7,211,4,Komboothi,886,452,434,43,25,18,0,0,0
8,211,4,Kooraikootam,268,104,164,9,5,4,0,0,0
9,211,4,Kudakottai,2186,1099,1087,313,154,159,0,0,0
10,211,4,Kulapatham,1909,957,952,658,321,337,0,0,0
11,211,4,Landai,2419,1235,1184,2112,1066,1046,0,0,0
12,211,4,Mallal,3118,1545,1573,2072,1013,1059,0,0,0
13,211,4,Mayakulam,7118,3968,3150,1169,591,578,0,0,0
14,211,4,Melamadai,1625,859,766,1311,692,619,0,0,0
15,211,4,Muthupettai,1550,689,861,1,1,0,0,0,0
16,211,4,Nainamarakkam,2033,1020,1013,84,46,38,0,0,0
17,211,4,Nalirukkai,1216,594,622,440,222,218,0,0,0
18,211,4,Methalodai,1149,556,593,0,0,0,0,0,0
19,211,4,Panaikulam,773,378,395,370,181,189,0,0,0
20,211,4,Panayadiyendal,1257,629,628,1178,592,586,0,0,0
21,211,4,Pathiratharavai,1182,595,587,78,42,36,0,0,0
22,211,4,Periapattinam,9730,5099,4631,338,195,143,0,0,0
23,211,4,Raghunathapuram,5710,2942,2768,100,49,51,0,0,0
24,211,4,Sethukarai,1509,788,721,295,147,148,0,0,0
25,211,4,Thillaiyenthal,7471,4033,3438,2816,1404,1412,0,0,0
26,211,4,Thathanendal,2092,1027,1065,1442,698,744,0,0,0
27,211,4,Thinaikulam,2057,1022,1035,78,40,38,0,0,0
28,211,4,Tiruppullani,1998,1002,996,378,187,191,0,0,0
29,211,4,Utharavai,1098,515,583,25,14,11,0,0,0
30,211,4,Utrakosamangai,2134,1123,1011,261,140,121,0,0,0
31,211,4,Valanoor,1276,655,621,724,362,362,0,0,0
32,211,4,Vannankundu,4955,2536,2419,105,59,46,0,0,0
33,211,4,Vellamarichukkatti,1815,866,949,1176,559,617,0,0,0
1,210,5,Achankudi,2028,1029,999,663,333,330,0,0,0
2,210,5,Andavorani,2176,1054,1122,426,210,216,0,0,0
3,210,5,Anjukottai,3116,1565,1551,656,333,323,0,0,0
4,210,5,Arasathur,2655,1323,1332,230,118,112,0,0,0
5,210,5,Arumbur,1922,972,950,159,76,83,0,0,0
6,210,5,Athiyur,1772,912,860,396,205,191,0,0,0
7,210,5,Kadambur,1870,955,915,394,200,194,0,0,0
8,210,5,Kaliyanagari,3155,1584,1571,197,99,98,0,0,0
9,210,5,Kallur,3837,1965,1872,751,389,362,0,0,0
10,210,5,Karankadu,1736,888,848,0,0,0,0,0,0
11,210,5,Karumozhi Sananvayal,1473,747,726,383,201,182,0,0,0
12,210,5,Kattavilagam,1681,897,784,317,163,154,0,0,0
13,210,5,Kattivayal,2551,1301,1250,232,127,105,0,0,0
14,210,5,Kodanur,2376,1178,1198,366,179,187,0,0,0
15,210,5,Kodipangu,1666,828,838,179,93,86,0,0,0
16,210,5,Kookudi,2731,1401,1330,745,366,379,0,0,0
17,210,5,Kulathur,2015,1049,966,316,155,161,1,0,1
18,210,5,Kunjankulam,1992,1074,918,350,199,151,0,0,0
19,210,5,Mangalagudi,2874,1472,1402,318,164,154,0,0,0
20,210,5,Mavur,951,444,507,172,82,90,0,0,0
21,210,5,Mugilthagam,3774,1935,1839,1232,639,593,21,10,11
22,210,5,Mullimunai,2002,1000,1002,1984,990,994,0,0,0
23,210,5,Nagrikathan,1311,653,658,78,42,36,0,0,0
24,210,5,Nambuthalai,8064,4019,4045,655,317,338,0,0,0
25,210,5,Neyvayal,2390,1173,1217,651,326,325,0,0,0
26,210,5,Nilamalagiyamangalam,1169,588,581,164,80,84,0,0,0
27,210,5,Orikottai,925,460,465,209,103,106,0,0,0
28,210,5,Orur,3330,1663,1667,115,55,60,0,0,0
29,210,5,Paganur,1432,722,710,438,216,222,0,0,0
30,210,5,Palangulam,1270,603,667,144,69,75,2,0,2
31,210,5,Panachayal,2121,1089,1032,857,437,420,0,0,0
32,210,5,Pandugudi,2558,1291,1267,413,205,208,0,0,0
33,210,5,Pathanagudi,817,395,422,199,99,100,0,0,0
34,210,5,Periakeeramangalam,3613,1898,1715,579,295,284,0,0,0
35,210,5,Pudupattinam,1614,808,806,347,194,153,0,0,0
36,210,5,Pullakadamban,2035,1034,1001,243,124,119,145,68,77
37,210,5,Sirugambaiyur,1726,889,837,124,62,62,0,0,0
38,210,5,Sirumalaikkottai,1019,497,522,95,49,46,0,0,0
39,210,5,Sundarapandianpattinam,4007,2003,2004,0,0,0,0,0,0
40,210,5,T.Nagani  Alangurani,2261,1110,1151,615,302,313,0,0,0
41,210,5,Thalirmarungur,2302,1146,1156,207,109,98,0,0,0
42,210,5,Thelur,2525,1251,1274,41,20,21,0,0,0
43,210,5,Thiruvadanai,4333,2145,2188,1108,551,557,15,8,7
44,210,5,Tiruvetriyur,1385,710,675,253,126,127,0,0,0
45,210,5,Tuthagudi,1174,541,633,101,46,55,0,0,0
46,210,5,Vattanam,1823,914,909,133,61,72,0,0,0
47,210,5,Vellayapuram,2662,1328,1334,72,35,37,0,0,0
1,209,6,Ariyakudiputhur,3583,1823,1760,1360,689,671,0,0,0
2,209,6,Bogalur,5402,2794,2608,2124,1067,1057,0,0,0
3,209,6,Ettivayal,1983,1000,983,660,327,333,0,0,0
4,209,6,K.Valasai,1999,1011,988,252,128,124,0,0,0
5,209,6,Kamankottai,2416,1226,1190,2021,1032,989,0,0,0
6,209,6,Karuthanendhal,548,281,267,307,159,148,0,0,0
7,209,6,Kavithaikudi,624,310,314,228,117,111,0,0,0
8,209,6,Keelambal,1259,613,646,303,140,163,0,0,0
9,209,6,Kodikulam,781,395,386,263,139,124,0,0,0
10,209,6,Kumukkottai,836,391,445,214,108,106,0,0,0
11,209,6,Manjakollai,820,407,413,260,127,133,0,0,0
12,209,6,Manjur,2509,1229,1280,1406,684,722,0,0,0
13,209,6,Mennendhinagachi,2427,1230,1197,1194,602,592,0,0,0
14,209,6,Mudalur,1841,942,899,577,297,280,0,0,0
15,209,6,Muthuvayal,2011,1017,994,1217,628,589,1,1,0
16,209,6,Pandikanmoi,599,322,277,190,93,97,0,0,0
17,209,6,Pottithatti,1152,594,558,330,163,167,0,0,0
18,209,6,Semanur,1132,577,555,1,0,1,0,0,0
19,209,6,Sevvur,1972,1033,939,373,210,163,0,0,0
20,209,6,Seyyalur,512,273,239,267,139,128,0,0,0
21,209,6,T.Karungulam,1494,767,727,425,212,213,0,0,0
22,209,6,Theeyanur,883,457,426,575,308,267,0,0,0
23,209,6,Theivendranallur,1246,608,638,458,221,237,0,0,0
24,209,6,Urathur,1130,576,554,798,414,384,0,0,0
25,209,6,Vairavanendal,1800,908,892,749,376,373,0,0,0
26,209,6,Veeravanur,1025,512,513,548,275,273,0,0,0
1,212,7,A.Punavasal,2004,1007,997,42,20,22,0,0,0
2,212,7,A.Usilangulam,1262,644,618,336,175,161,0,0,0
3,212,7,Appanur,3329,1664,1665,124,55,69,0,0,0
4,212,7,Avathandai,2519,1211,1308,413,204,209,0,0,0
5,212,7,Chithirangudi,599,288,311,184,88,96,0,0,0
6,212,7,Enathi,1372,700,672,335,179,156,0,0,0
7,212,7,Ervadi,13366,6689,6677,1078,549,529,0,0,0
8,212,7,Idambadal,1902,888,1014,715,352,363,0,0,0
9,212,7,Ilanchembur,4002,1965,2037,52,24,28,0,0,0
10,212,7,Kadaladi,4831,2422,2409,469,236,233,1,0,1
11,212,7,Kadugusandai,2687,1368,1319,123,61,62,0,0,0
12,212,7,Kandilan,1468,742,726,309,163,146,0,0,0
13,212,7,Kanikoor,1187,618,569,27,16,11,0,0,0
14,212,7,Kannirajpuram,5086,2593,2493,77,29,48,0,0,0
15,212,7,Karunkulam,1755,909,846,465,249,216,0,0,0
16,212,7,Keelachirupodhu,2413,1161,1252,1159,554,605,0,0,0
17,212,7,Keelakidaram,2789,1355,1434,396,194,202,0,0,0
18,212,7,Keelasakkulam,1317,658,659,75,40,35,0,0,0
19,212,7,Keelaselvanur,2725,1382,1343,726,375,351,4,3,1
20,212,7,Kidathirukkai,2249,1140,1109,434,200,234,0,0,0
21,212,7,Kokkarankottai,528,261,267,179,94,85,0,0,0
22,212,7,Kondunallanpatti,1120,554,566,0,0,0,0,0,0
23,212,7,Kothankulam,2422,1216,1206,534,264,270,0,0,0
24,212,7,M.Karisalkulam,1053,556,497,1,1,0,0,0,0
25,212,7,Mangulam,856,400,456,122,48,74,0,0,0
26,212,7,Marandai,1594,821,773,751,395,356,0,0,0
27,212,7,Mariyur,5097,2510,2587,507,252,255,0,0,0
28,212,7,Meenangudi,1895,953,942,182,89,93,0,0,0
29,212,7,Melachirupodhu,1969,959,1010,363,179,184,0,0,0
30,212,7,Melakidaram,2399,1201,1198,239,121,118,0,0,0
31,212,7,Melaselvanur,2412,1223,1189,458,230,228,0,0,0
32,212,7,Mookkaiyur,2981,1542,1439,32,17,15,0,0,0
33,212,7,Narippaiyur,9861,5010,4851,604,301,303,7,6,1
34,212,7,Oppilan,2506,1275,1231,0,0,0,0,0,0
35,212,7,Orivayal,2006,1049,957,415,209,206,0,0,0
36,212,7,Oruvanendal,1029,508,521,11,5,6,0,0,0
37,212,7,P.Keerandai,1970,1011,959,615,317,298,0,0,0
38,212,7,Panivasal,1323,709,614,295,162,133,0,0,0
39,212,7,Pannanthai,541,289,252,140,73,67,0,0,0
40,212,7,Peikulam,1086,540,546,265,118,147,0,0,0
41,212,7,Periakulam,1120,555,565,45,21,24,0,0,0
42,212,7,Pillayarkulam,2226,1136,1090,590,287,303,0,0,0
43,212,7,Pothikulam,2203,1150,1053,335,185,150,0,0,0
44,212,7,S.Keeerandai,1046,513,533,36,19,17,0,0,0
45,212,7,S.Tharaikudi,3815,1942,1873,998,510,488,0,0,0
46,212,7,S.Vagaikulam,1401,686,715,707,337,370,0,0,0
47,212,7,Senjudainathapuram,607,297,310,0,0,0,0,0,0
48,212,7,Sethurajapuram,493,244,249,118,59,59,0,0,0
49,212,7,Sevalpatti,2459,1227,1232,897,430,467,0,0,0
50,212,7,Sikkal,6858,3559,3299,1869,959,910,0,0,0
51,212,7,Siraikulam,2647,1351,1296,801,405,396,0,0,0
52,212,7,Sokkanai,2048,992,1056,435,217,218,0,0,0
53,212,7,Sonaipiriyankottai,586,283,303,40,21,19,0,0,0
54,212,7,Souripattinam,1574,798,776,0,0,0,0,0,0
55,212,7,T.Karisalkulam,888,448,440,6,3,3,0,0,0
56,212,7,T.Veppangulam,1898,941,957,363,179,184,0,0,0
57,212,7,Thanichiyam,1808,917,891,354,182,172,0,0,0
58,212,7,Tirumalugandankottai,904,447,457,64,32,32,0,0,0
59,212,7,Uchinatham,1011,493,518,180,85,95,0,0,0
60,212,7,Valinockam,7464,3802,3662,13,5,8,0,0,0
1,212,8,A.Tharaikkudi,1630,820,810,338,171,167,0,0,0
2,212,8,Achchangulam,2863,1401,1462,1283,611,672,0,0,0
3,212,8,Anaiyur,1794,939,855,424,211,213,0,0,0
4,212,8,Ariamangalam,1188,615,573,35,20,15,0,0,0
5,212,8,Eluvanur,1413,689,724,781,385,396,0,0,0
6,212,8,Erumaikulam,1448,753,695,76,37,39,0,0,0
7,212,8,Idayankulam,850,436,414,46,24,22,0,0,0
8,212,8,Idivilagi,800,417,383,8,4,4,0,0,0
9,212,8,Ilanthaikulam,1368,690,678,296,153,143,0,0,0
10,212,8,K.Nedungulam,2042,1037,1005,498,253,245,0,0,0
11,212,8,K.Veppangulam,1699,875,824,10,3,7,0,0,0
12,212,8,Kadamangalam,1634,840,794,144,74,70,0,0,0
13,212,8,Kakkudi,1175,603,572,112,54,58,0,0,0
14,212,8,Kathanendal,2063,1009,1054,78,42,36,0,0,0
15,212,8,Keelamudimannarkottai,2923,1482,1441,206,94,112,0,0,0
16,212,8,Keelaramanadhi,1597,835,762,68,35,33,0,0,0
17,212,8,Komboothi,1366,721,645,45,20,25,0,0,0
18,212,8,Kovilangulam,3912,1974,1938,1495,737,758,0,0,0
19,212,8,M.pudukulam,1676,848,828,186,85,101,0,0,0
20,212,8,Mandalamanickam,4989,2549,2440,877,447,430,0,0,0
21,212,8,Maraikkulam,1439,713,726,44,21,23,0,0,0
22,212,8,Mavilangai,1031,531,500,22,12,10,0,0,0
23,212,8,Melamudimannarkottai,1231,616,615,81,43,38,0,0,0
24,212,8,Melaramanadhi,1225,596,629,101,46,55,0,0,0
25,212,8,Mudalnadu,989,475,514,18,7,11,0,0,0
26,212,8,Musittaikurichi,4496,2204,2292,1414,696,718,0,0,0
27,212,8,N.Karisalkulam,2166,1083,1083,41,20,21,0,0,0
28,212,8,Nagarathakurichi,944,481,463,129,71,58,0,0,0
29,212,8,Narayanapuram,4560,2242,2318,437,214,223,0,0,0
30,212,8,Natham,2562,1329,1233,500,242,258,0,0,0
31,212,8,Neeravi,2515,1287,1228,393,198,195,0,0,0
32,212,8,O.Karisalkulam,2470,1216,1254,1281,631,650,0,0,0
33,212,8,Pakkuvetti,3613,1855,1758,562,289,273,0,0,0
34,212,8,Pammanendal,1178,590,588,40,23,17,0,0,0
35,212,8,Pappanam,1059,534,525,842,423,419,0,0,0
36,212,8,K.Pappankulam,1883,962,921,38,21,17,0,0,0
37,212,8,Pappurediyapatti,1471,725,746,67,32,35,0,0,0
38,212,8,Pasumpon,2619,1467,1152,499,254,245,0,0,0
39,212,8,Peraiyur,7433,3764,3669,5458,2764,2694,0,0,0
40,212,8,Perunali,3755,1918,1837,661,348,313,0,0,0
41,212,8,Ponthampuli,669,300,369,88,45,43,0,0,0
42,212,8,Pudukkottai,1052,533,519,49,27,22,0,0,0
43,212,8,Pulvoikulam,1717,894,823,800,405,395,0,0,0
44,212,8,Ramasamypatti,3657,1850,1807,67,31,36,0,0,0
45,212,8,Sadayanendal,2011,1007,1004,109,47,62,0,0,0
46,212,8,Sengappadai,1734,884,850,519,261,258,0,0,0
47,212,8,T.Punavasal,2674,1307,1367,892,436,456,0,0,0
48,212,8,T.Valasubramaniapuram,1336,655,681,73,37,36,0,0,0
49,212,8,Thimmanathapuram,2229,1162,1067,0,0,0,0,0,0
50,212,8,Udayanathapuram,3858,1920,1938,1868,924,944,0,0,0
51,212,8,Valayapookulam,1325,647,678,274,136,138,0,0,0
52,212,8,Valanthai,1867,941,926,975,493,482,0,0,0
53,212,8,Vangarupuram,1946,1013,933,886,475,411,0,0,0
1,212,9,Alanganur,1782,936,846,798,439,359,0,0,0
2,212,9,Anaiseri,956,503,453,0,0,0,0,0,0
3,212,9,Arapothu,1378,697,681,1191,606,585,0,0,0
4,212,9,Athanakurichi,1702,848,854,560,289,271,0,0,0
5,212,9,Athankothangudi,1699,886,813,847,443,404,0,0,0
6,212,9,Athikulam,1032,488,544,296,139,157,0,0,0
7,212,9,Kakkoor,2865,1433,1432,946,475,471,0,0,0
8,212,9,Karumal,1075,532,543,578,276,302,0,0,0
9,212,9,Kathakulam,559,273,286,245,128,117,0,0,0
10,212,9,Keelakanjarankulam,1113,557,556,442,222,220,0,0,0
11,212,9,Keelakodumalur,1597,793,804,1037,489,548,0,0,0
12,212,9,Keelakulam,1782,880,902,543,265,278,0,0,0
13,212,9,Keelathooval,2679,1290,1389,84,43,41,0,0,0
14,212,9,Keeranur,1905,975,930,383,195,188,0,0,0
15,212,9,Kolundurai,2082,938,1144,800,383,417,3,3,0
16,212,9,Kumarakkurichi,1597,850,747,508,268,240,0,0,0
17,212,9,Mahindi,1895,921,974,371,188,183,0,0,0
18,212,9,Manaloor,1450,722,728,280,146,134,0,0,0
19,212,9,Melakanniseri,1165,557,608,67,28,39,0,0,0
20,212,9,Melakodumalur,2205,1109,1096,963,475,488,0,0,0
21,212,9,Michaelpattinam,742,367,375,26,15,11,0,0,0
22,212,9,Nallukurichi,2172,1146,1026,284,151,133,0,0,0
23,212,9,Nallur,709,328,381,35,16,19,0,0,0
24,212,9,Palangulam,720,359,361,652,324,328,0,0,0
25,212,9,Periaelai,1072,520,552,1069,520,549,0,0,0
26,212,9,Pirabakkalur,2082,927,1155,670,317,353,0,0,0
27,212,9,Ponnakkaneri,2295,1139,1156,352,180,172,0,0,0
28,212,9,Pooseri,2178,1111,1067,248,121,127,0,0,0
29,212,9,Posukkudi,1230,618,612,281,135,146,0,0,0
30,212,9,Pulithikulam,1320,674,646,533,265,268,0,0,0
31,212,9,Puliyangudi,2478,1246,1232,948,482,466,0,0,0
32,212,9,Sambakulam,1883,924,959,514,250,264,0,0,0
33,212,9,Sathanur,1650,870,780,267,144,123,1,1,0
34,212,9,Sellur,2540,1273,1267,1064,519,545,1,0,1
35,212,9,Selvanayagapuram,2589,1314,1275,7,3,4,0,0,0
36,212,9,Sembongudi,808,380,428,343,168,175,0,0,0
37,212,9,Sirugudi,1500,753,747,0,0,0,0,0,0
38,212,9,Siruthalai,1903,954,949,921,449,472,0,0,0
39,212,9,Theriruveli,5314,2666,2648,1766,896,870,0,0,0
40,212,9,Thiruvarangam,2057,1138,919,477,277,200,0,0,0
41,212,9,Ulaiyur,2041,1037,1004,595,292,303,0,0,0
42,212,9,Velanadu,2104,1034,1070,317,151,166,0,0,0
43,212,9,Vengalakurichi,2169,1047,1122,428,219,209,0,0,0
44,212,9,Vikkiramapandiapuram,1172,569,603,140,72,68,0,0,0
45,212,9,Vilakanendal,842,397,445,322,154,168,0,0,0
46,212,9,Vilangalathur,4081,1952,2129,1773,865,908,0,0,0
1,209,10,A.Panaiyur,926,489,437,104,65,39,0,0,0
2,209,10,Akkiramesi,1811,887,924,70,36,34,0,0,0
3,209,10,Anjamadai,1382,632,750,289,127,162,0,0,0
4,209,10,Arasanur,1002,537,465,122,66,56,0,0,0
5,209,10,Ariyankottai,1478,671,807,203,95,108,0,0,0
6,209,10,Attangudi,1595,804,791,457,231,226,0,0,0
7,209,10,Gangaikondan,932,471,461,200,97,103,0,0,0
8,209,10,Kalliyadiyendal,683,353,330,3,0,3,0,0,0
9,209,10,Karadaranthakudi,1726,873,853,254,135,119,0,0,0
10,209,10,Keelakavanoor,802,401,401,111,57,54,0,0,0
11,209,10,Kiliyur,1430,705,725,455,218,237,0,0,0
12,209,10,Koluvur,812,405,407,200,94,106,0,0,0
13,209,10,Kottakudi,859,401,458,1,0,1,1,1,0
14,209,10,Kulathur,1380,709,671,989,513,476,0,0,0
15,209,10,Manakudi,526,282,244,38,22,16,0,0,0
16,209,10,Mummudisathan,663,335,328,226,116,110,0,0,0
17,209,10,Nagaram,1516,716,800,117,56,61,0,0,0
18,209,10,Nagaramangalam,1464,731,733,197,93,104,0,0,0
19,209,10,Nainarkoil,1800,901,899,283,138,145,0,0,0
20,209,10,P.Kodikulam,1342,669,673,10,5,5,0,0,0
21,209,10,Pagaivendri,876,443,433,189,105,84,0,0,0
22,209,10,Pandappanendal,1067,531,536,92,51,41,0,0,0
23,209,10,Pandiyur,1365,679,686,463,230,233,1,0,1
24,209,10,Perungalur,1325,662,663,373,196,177,0,0,0
25,209,10,Pottagavayal,2265,970,1295,538,239,299,0,0,0
26,209,10,Radhappuli,1615,815,800,482,252,230,0,0,0
27,209,10,Sadurvedamangalam,931,458,473,275,133,142,0,0,0
28,209,10,Sirakikottai,1002,506,496,0,0,0,0,0,0
29,209,10,Siruvayal,2084,1100,984,525,274,251,0,0,0
30,209,10,Thalayadikottai,2022,1031,991,150,68,82,0,0,0
31,209,10,Thavalaikulam,601,264,337,70,36,34,0,0,0
32,209,10,Thethangal,1044,531,513,646,332,314,0,0,0
33,209,10,Thiyagavanseri,653,350,303,417,226,191,0,0,0
34,209,10,Vadavaneri,896,423,473,143,62,81,0,0,0
35,209,10,Vagavayal,1045,542,503,210,111,99,0,0,0
36,209,10,Vallam,2131,1075,1056,796,397,399,0,0,0
37,209,10,Vaniyavallam,1308,672,636,670,336,334,0,0,0
1,209,11,Ariyanendal,2003,998,1005,433,214,219,0,0,0
2,209,11,Enathikottai,778,380,398,618,308,310,0,0,0
3,209,11,K.Karungulam,921,457,464,537,259,278,0,0,0
4,209,11,Kalayur,2544,1299,1245,1576,797,779,0,0,0
5,209,11,Kallikudi,1277,662,615,1131,584,547,0,0,0
6,209,11,Kamuthakudi,3474,1756,1718,844,430,414,0,0,0
7,209,11,Kanjiyendal,2037,1047,990,0,0,0,0,0,0
8,209,11,Keelaparthibanur,1770,902,868,956,476,480,0,0,0
9,209,11,Keelaparuthiyur,804,408,396,18,6,12,0,0,0
10,209,11,Kulandapuri Arungulam,1791,912,879,801,414,387,0,0,0
11,209,11,Madanthai,1586,812,774,467,231,236,0,0,0
12,209,11,Melaparthibanur,8232,4131,4101,2157,1075,1082,0,0,0
13,209,11,Melayakudi,3468,1758,1710,534,261,273,0,0,0
14,209,11,Melkavanur,841,443,398,11,7,4,0,0,0
15,209,11,Mosukkudi,1783,919,864,497,265,232,0,0,0
16,209,11,Nelmadur,1483,691,792,1192,563,629,0,0,0
17,209,11,Nenmeni,1603,846,757,526,263,263,0,0,0
18,209,11,P.Puthur,1255,638,617,244,118,126,0,0,0
19,209,11,Pambur,2150,1058,1092,1036,508,528,0,0,0
20,209,11,Peerkankurichi,1386,709,677,383,206,177,0,0,0
21,209,11,Perungarai,3061,1572,1489,567,286,281,0,0,0
22,209,11,Poduvakudi,892,448,444,250,125,125,0,0,0
23,209,11,Pudugudi,1625,849,776,745,389,356,1,1,0
24,209,11,S.Andakkudi,3220,1639,1581,1822,941,881,0,0,0
25,209,11,S.Kavanur,1096,535,561,895,440,455,0,0,0
26,209,11,Soodiyur,1464,720,744,331,156,175,0,0,0
27,209,11,Thaduthalankottai,974,484,490,268,138,130,0,0,0
28,209,11,Thelichathanallur,7120,3655,3465,1049,557,492,5,1,4
29,209,11,Thenpoduvakudi,479,257,222,277,151,126,0,0,0
30,209,11,Thinaikulam,941,474,467,353,177,176,0,0,0
31,209,11,Tholur,1225,644,581,791,427,364,0,0,0
32,209,11,Urakkudi,1111,590,521,809,437,372,0,0,0
33,209,11,Urappuli,2672,1365,1307,513,258,255,0,0,0
34,209,11,Valangudi,1027,517,510,310,161,149,0,0,0
35,209,11,Valimarichan,2075,1051,1024,468,223,245,0,0,0
36,209,11,Vendoni,5237,2694,2543,1579,819,760,66,37,29
37,209,11,Vengalur,1623,813,810,1122,569,553,0,0,0
38,209,11,Venkittankurichi,2375,1156,1219,1055,528,527,0,0,0
39,209,11,Vilathur,1817,904,913,174,86,88,0,0,0
